R   1600 900

NO  ./NOD_awa/nod_t9arad.xpm 
SO  ./NOD_awa/nod_t9asa7.xpm
WE  ./NOD_awa/nod_t9arba3.xpm
EA  ./NOD_awa/nod_t9asi.xpm
S   ./NOD_awa/nod_t9awas.xpm
S1  ./NOD_awa/nod_t9a llah.xpm

F   77 ,60,47
C   13,71,  161dfdf155

11111111111111111111    1111111111111111  111111111111211
                1001    1000000000000001  110000000000001  
               1001     1000000000000001    11111141111
              1001      1111111111111111    10000000001
            1001        11            11    
           1001         11            11  
          1001          11            11  
         1001           11            11
        1001
       1001
      1001
    1001
   1001
  1001
1001
1111111111111111 